010001000100020001
010203010101030101
910203010101020101
010203020101030101
010203030101020108
010203020101030101
010203010101020101
010203010101030101
010103010101020101
000100010001000101
#
2 1
7 1
5 2
14 0
100 6
0 50